0--3-5---3--0
0----45-5-5-0
011111111---0
0-5-5---5---0
011175--4---0
0---17--11110
0----11-----0
0----5-4---600
0222111111110